type octile
height 10
width 10
map
TTTTTTTTTT
T.....s.TT
T.TTTTT..T
T2.....3.T
T...T...TT
T1.....4.T
T.T...T.TT
TT..T...TT
TTT..eTTTT
TTTTTTTTTT