type octile
height 10
width 10
map
TTTTTTTTTT
T.....s.TT
T.TTTTT..T
T1....2..T
T.T.TTTTTT
T.T......T
T.T.TTT.TT
TT..T...TT
TTT..eTTTT
TTTTTTTTTT