type octile
height 20
width 20
map
TTTTTTTTTTTTTTTTTTTT
Ts......T....8..T..T
T.TTTTTTTTTTT.T.T..T
T5........T.T.T....T
T.TTTT..TTT.T.TTT.TT
T.T.......T.T.T....T
T.T.TTTTT.T.T.T.T.7T
T...T......6..T.T..T
TTT.T.TTTTTTT.T.T..T
T...T....Te...T.T..T
T.TTTTT.TTTTT.T.TT.T
T.................1T
T.TTTTT.TTT.TTTTTT.T
T4....T3......T....T
T.TTT.T.TTTTT.TTT.TT
T.T.T...T..2T...T..T
T.T.T.T.T.T.T.TTTT.T
T.T...T.T.T.T...T..T
T.T.T.....T........T
TTTTTTTTTTTTTTTTTTTT