type octile
height 20
width 20
map
TTTTTTTTTTTTTTTTTTTT
Ts......T....8..T..T
T.TTTTTTTTTTT.T.T..T
T6........T.T.T....T
T.TTTT..TTT.T.TTT.TT
T.T3......T.T2T....T
T.T.TTTTT.T.T.T.T..T
T...T...T.....T.T.7T
TTT.T.TTT.TTT.TTT..T
T...T.....Te..T.T..T
T.TTTTT.TTTTT.T.TT.T
T...T.T.T...T.....1T
T.TTT.T.TTT.TTTTTT.T
T4....T..5....T....T
T.TTT.T.TTTTT.TTT.TT
T.T.T...T...T...T..T
T.T.T.T.T.T.T.TTTT.T
T.T...T.T.T.T...T..T
T.T.T.....T........T
TTTTTTTTTTTTTTTTTTTT